a1111111111111111111111111111111111
1900000000000000000000000000000025
1011111111111111111111101111111011
1010000000010000000011101111101011
1011110111011111111000000000001011
1010000001000000011111111111101011
1011111101011111000100000000001001
1010000001011111010101111111111101
1010111111010001010101101000000101
1010100000010101011111101011110101
1010101111110101011110001011110101
1010111111100101001110101010000101
1010000000001101101000100010111101
1011111111101100001011111110111101
1000000000001110111000000010000001
1111111111231111111111112411111111

b1111111111111111111111111111111111
1100000000000000000000000000000025
1111111017111111101111101111101011
1111000000010000000011101111101011
1011610111011111111000000000001011
1010000001000000011111111111101011
1011111101011111000100000000001001
1000000001011111010101111111011101
1010111011010001010101101000000101
1010100000010101011111101011110101
1010101111110101011110001011110101
1010101111100001001110101010000101
1010000000001101100000100010116101
1011111111101100001011111110111101
1000000000001110111000000000000001
1111111111230011111111112411111111

c1111111111111111111111111111111111
1111100111000000000000000006111025
1111101111111111110111101111111011
1110000000000000000011101111101011
1111111101111011111000000000000011
1110000001000000011111111111101111
1111111101011111111100000000000011
1110000000000007111101111111101001
1110111111010000000000001000000101
1110100000010101011111101011110101
1110101111110101011110001011110101
1110101111100101001110101010000101
1110000000001101100000100010111101
1161111111101100001011111110111101
1100000000001110111000000010000001
1111111111231011111111112411111111

d1111111111111111111111111111111111
1110011110000000111110000000000025
1110111110111101110111111110111011
1110000000111100000011111000101011
1011101111111111111000000011101011
1010000011100000011111011111101011
1011111001111111000100000000001011
1000000001111111010101111101111011
1010111111000001010101101000000011
1010000000010100011111101011110111
1011101111110101011111111011110111
1011101111100101000000001010000111
1011000000001101101111100010111101
1011111111101100101111111110111101
1000000000001110100000000010000001
1111111111231011111111112411111111

